[
  {
    "id": 1,
    "name": "\u041f\u043e\u0441\u0442 \u043c\u0435\u0434\u0441\u0435\u0441\u0442\u0440\u044b",
    "width": 40,
    "height": 15,
    "layout": [
      "########################################",
      "#......................................#",
      "#......................................#",
      "#...........####........####...........#",
      "#...........#..#........#..#...........#",
      "#...........####........####...........#",
      "#......................................#",
      "#......................................#",
      "#......................................#",
      "#...........####........####...........#",
      "#...........#..#........#..#...........#",
      "#...........####........####...........#",
      "#......................................#",
      "#......................................#",
      "########################################"
    ]
  },
  {
    "id": 2,
    "name": "\u041f\u0430\u043b\u0430\u0442\u043d\u044b\u0439 \u043a\u043e\u0440\u0438\u0434\u043e\u0440",
    "width": 40,
    "height": 15,
    "layout": [
      "########################################",
      "#......................................#",
      "#....######..............######........#",
      "#....#....#..............#....#........#",
      "#....#....#..............#....#........#",
      "#....######..............######........#",
      "#......................................#",
      "#......................................#",
      "#......................................#",
      "#....######..............######........#",
      "#....#....#..............#....#........#",
      "#....######..............######........#",
      "#......................................#",
      "#......................................#",
      "########################################"
    ]
  },
  {
    "id": 3,
    "name": "\u0421\u043a\u043b\u0430\u0434 \u043c\u0435\u0434\u0438\u043a\u0430\u043c\u0435\u043d\u0442\u043e\u0432",
    "width": 40,
    "height": 15,
    "layout": [
      "########################################",
      "#......................................#",
      "#....########..........................#",
      "#....#......#..........................#",
      "#....#......#..........................#",
      "#....########..........................#",
      "#......................................#",
      "#....................########..........#",
      "#....................#......#..........#",
      "#....................#......#..........#",
      "#....................########..........#",
      "#......................................#",
      "#......................................#",
      "#......................................#",
      "########################################"
    ]
  },
  {
    "id": 4,
    "name": "\u0421\u043c\u043e\u0442\u0440\u043e\u0432\u0430\u044f",
    "width": 40,
    "height": 15,
    "layout": [
      "########################################",
      "#......................................#",
      "#......................................#",
      "#.............##########...............#",
      "#.............#........#...............#",
      "#.............#........#...............#",
      "#.............##########...............#",
      "#......................................#",
      "#......................................#",
      "#.......####................####.......#",
      "#.......#..#................#..#.......#",
      "#.......####................####.......#",
      "#......................................#",
      "#......................................#",
      "########################################"
    ]
  },
  {
    "id": 5,
    "name": "\u041a\u043e\u043c\u043d\u0430\u0442\u0430 \u0442\u0435\u0440\u0430\u043f\u0438\u0438",
    "width": 40,
    "height": 15,
    "layout": [
      "########################################",
      "#......................................#",
      "#......................................#",
      "#......######................######....#",
      "#......#....#................#....#....#",
      "#......######................######....#",
      "#......................................#",
      "#......................................#",
      "#......................................#",
      "#...............########...............#",
      "#...............#......#...............#",
      "#...............########...............#",
      "#......................................#",
      "#......................................#",
      "########################################"
    ]
  }
]
